 # #     # #         # #     
 # # ##### ####### ### # ### 
   #       # # #     # #   # 
## ### ##### # ##### # # ####
         #           #       
#### ### # ### # # ##### ####
       #   #   # #         # 
#### ### ### # # ##### # ### 
       #   # # # # # # #   # 
######## # # ##### # # # ### 
 #     # # # #     #   #   # 
 # ### ### ##### # # ####### 
     # #       # # # # #     
 ### ##### ### # ### # ### # 
   #   #   # # # # # #   # # 
 ### # # ### # # # ##### # ##
 #   #   #   #       #       
#### ### # # # # ### # # # # 
     #   # #   #   #   # # # 
