     #           # #     #   
 # # # # ####### # ##### ### 
 # #   #       # # # # #     
## ### # ######### # # # ### 
     # # #               # # 
#### # ##### ### ##### ### # 
     #   # #   # #   #     # 
## ####### ### # # ##### ### 
       #     # # #       #   
 # ##### # ### ### ##### ####
 #     # #     #     #     # 
#### ##### ########### ##### 
           #   # #   # #     
## # ### # # ### # ### # # # 
 # # #   #   # #   #     # # 
 # ##### ##### # ######### ##
   # #         # # # #       
#### # # # # # # # # ### # # 
       # # # #       #   # # 
