 # # #   # #     #     # # # 
 # # ### # # ### # # ### # # 
     # #   # #   # # #       
 ### # ### ### ### ### ### ##
 # #   # # # #           #   
## # ### # # ##### ####### # 
 #       #   #     #     # # 
 # ##### # ### ##### ### ####
   #   # # # #     # #   #   
## # ##### # # ### ### # # ##
             # # #     #     
 ### ### # # # # # ####### ##
   # #   # #   #   #     #   
## # # ##### # ####### ### ##
   # #     # #   #     #     
## ##### ####### ##### ### # 
   # # # #   #     #       # 
 ### # ### # # ### ### ##### 
 #         #   #   #       # 
